rmAttributeDataType	KEYWORD1
rmOutputAttribute	KEYWORD1

rmString	KEYWORD1


rmCreateInputAttribute	KEYWORD2
rmInputAttributeSetBoundaries	KEYWORD2
rmInputAttributeSetOnChange	KEYWORD2
rmOutputAttributeUpdate	KEYWORD2
rmOutputAttributeGetStringData	KEYWORD2

rmCreateCall	KEYWORD2

rmProcessMessage	KEYWORD2
rmSendCommand	KEYWORD2
rmEcho	KEYWORD2
rmWarn	KEYWORD2
rmError	KEYWORD2

rmSendRequest	KEYWORD2

rmCreateString	KEYWORD2

rmCreateSync	KEYWORD2
rmCreateOutputAttribute	KEYWORD2
rmSyncUpdate	KEYWORD2

rmConnectUART	KEYWORD2
rmConnectUART1	KEYWORD2
rmConnectUART2	KEYWORD2
rmConnectUART3	KEYWORD2


RM_ATTRIBUTE_BOOL	LITERAL1
RM_ATTRIBUTE_CHAR	LITERAL1
RM_ATTRIBUTE_STRING	LITERAL1
RM_ATTRIBUTE_CHAR	LITERAL1
RM_ATTRIBUTE_UINT8	LITERAL1
RM_ATTRIBUTE_UINT16	LITERAL1
RM_ATTRIBUTE_UINT32	LITERAL1
RM_ATTRIBUTE_INT8	LITERAL1
RM_ATTRIBUTE_INT16	LITERAL1
RM_ATTRIBUTE_INT32	LITERAL1
RM_ATTRIBUTE_FLOAT	LITERAL1
